//MAP CONVERTED BY dmm2tgm.py THIS HEADER COMMENT PREVENTS RECONVERSION, DO NOT REMOVE
"a" = (
/obj/structure/table/holotable,
/obj/machinery/readybutton,
/obj/effect/floor_decal/corner/red/three_quarters{
	dir = 8
	},
/turf/simulated/floor/holofloor/tiled,
/area/holodeck/thunderdomecourt)
"b" = (
/obj/structure/window/reinforced/holowindow/disappearing{
	dir = 1
	},
/obj/effect/floor_decal/corner/green{
	dir = 5
	},
/turf/simulated/floor/holofloor/tiled,
/area/holodeck/thunderdomecourt)
"d" = (
/obj/effect/floor_decal/corner/red{
	dir = 9
	},
/turf/simulated/floor/holofloor/tiled,
/area/holodeck/thunderdomecourt)
"e" = (
/obj/structure/table/holotable,
/obj/item/clothing/head/helmet/thunderdome,
/obj/item/clothing/suit/armor/tdome/red,
/obj/item/clothing/under/color/red,
/obj/item/weapon/holo/esword/red,
/obj/effect/floor_decal/corner/red{
	dir = 5
	},
/turf/simulated/floor/holofloor/tiled,
/area/holodeck/thunderdomecourt)
"j" = (
/obj/structure/table/holotable,
/obj/item/clothing/head/helmet/thunderdome,
/obj/item/clothing/suit/armor/tdome/green,
/obj/item/clothing/under/color/green,
/obj/item/weapon/holo/esword/green,
/obj/effect/floor_decal/corner/green{
	dir = 10
	},
/turf/simulated/floor/holofloor/tiled,
/area/holodeck/thunderdomecourt)
"k" = (
/obj/structure/window/reinforced/holowindow/disappearing,
/obj/effect/floor_decal/corner/red/three_quarters{
	dir = 4
	},
/turf/simulated/floor/holofloor/tiled,
/area/holodeck/thunderdomecourt)
"l" = (
/obj/structure/window/reinforced/holowindow/disappearing{
	dir = 1
	},
/obj/effect/floor_decal/corner/green/three_quarters{
	dir = 1
	},
/turf/simulated/floor/holofloor/tiled,
/area/holodeck/thunderdomecourt)
"p" = (
/obj/structure/table/holotable,
/obj/effect/floor_decal/corner/red/three_quarters{
	dir = 1
	},
/turf/simulated/floor/holofloor/tiled,
/area/holodeck/thunderdomecourt)
"r" = (
/obj/effect/floor_decal/corner/green{
	dir = 6
	},
/turf/simulated/floor/holofloor/tiled,
/area/holodeck/thunderdomecourt)
"A" = (
/obj/structure/table/holotable,
/obj/effect/floor_decal/corner/green/three_quarters,
/turf/simulated/floor/holofloor/tiled,
/area/holodeck/thunderdomecourt)
"B" = (
/obj/structure/table/holotable,
/obj/machinery/readybutton,
/obj/effect/floor_decal/corner/green/three_quarters{
	dir = 4
	},
/turf/simulated/floor/holofloor/tiled,
/area/holodeck/thunderdomecourt)
"C" = (
/obj/machinery/door/window/holowindoor{
	base_state = "right";
	dir = 4;
	icon_state = "right";
	name = "Green Team"
	},
/turf/simulated/floor/holofloor/tiled/dark,
/area/holodeck/thunderdomecourt)
"E" = (
/obj/effect/floor_decal/corner/green{
	dir = 9
	},
/turf/simulated/floor/holofloor/tiled,
/area/holodeck/thunderdomecourt)
"H" = (
/turf/simulated/floor/holofloor/tiled/dark,
/area/holodeck/thunderdomecourt)
"I" = (
/obj/structure/window/reinforced/holowindow/disappearing,
/obj/effect/floor_decal/corner/red/three_quarters,
/turf/simulated/floor/holofloor/tiled,
/area/holodeck/thunderdomecourt)
"J" = (
/obj/structure/window/reinforced/holowindow/disappearing{
	dir = 1
	},
/obj/effect/floor_decal/corner/green/three_quarters{
	dir = 8
	},
/turf/simulated/floor/holofloor/tiled,
/area/holodeck/thunderdomecourt)
"L" = (
/obj/structure/window/reinforced/holowindow/disappearing,
/obj/effect/floor_decal/corner/red{
	dir = 10
	},
/turf/simulated/floor/holofloor/tiled,
/area/holodeck/thunderdomecourt)
"R" = (
/obj/effect/floor_decal/corner/red{
	dir = 6
	},
/turf/simulated/floor/holofloor/tiled,
/area/holodeck/thunderdomecourt)
"S" = (
/obj/structure/holostool,
/turf/simulated/floor/holofloor/tiled,
/area/holodeck/thunderdomecourt)
"U" = (
/obj/structure/holostool,
/obj/structure/window/reinforced/holowindow{
	dir = 4
	},
/turf/simulated/floor/holofloor/tiled,
/area/holodeck/thunderdomecourt)
"W" = (
/turf/simulated/floor/holofloor/tiled,
/area/holodeck/thunderdomecourt)
"X" = (
/obj/machinery/door/window/holowindoor{
	dir = 4;
	name = "Red Team"
	},
/turf/simulated/floor/holofloor/tiled/dark,
/area/holodeck/thunderdomecourt)

(1,1,1) = {"
H
H
H
H
H
H
H
H
H
H
"}
(2,1,1) = {"
S
S
H
S
S
S
S
H
S
S
"}
(3,1,1) = {"
U
U
X
U
U
U
U
C
U
U
"}
(4,1,1) = {"
a
d
d
d
I
J
E
E
E
A
"}
(5,1,1) = {"
e
W
W
W
L
b
W
W
W
j
"}
(6,1,1) = {"
e
W
W
W
L
b
W
W
W
j
"}
(7,1,1) = {"
e
W
W
W
L
b
W
W
W
j
"}
(8,1,1) = {"
e
W
W
W
L
b
W
W
W
j
"}
(9,1,1) = {"
e
W
W
W
L
b
W
W
W
j
"}
(10,1,1) = {"
p
R
R
R
k
l
r
r
r
B
"}
